"Date","Time","TimeZone","Name","Type","Status","Currency","Gross","Fee","Net","From Email Address","To Email Address","Transaction ID","Item Title","Item ID","Reference Txn ID","Receipt ID","Balance","Note"
"10/01/2019","03:46:20","PDT","Calm Radio","Subscription Payment","Completed","USD","-6.99","0.00","-6.99","simon@joyful.com","memberships@calmradio.com","06P57143A2806728E","MONTHLY - $1 for the first 2 Months: Me - Order 99309. Item total: $1.00 USD first 2 months, then $6.99 / Month","","I-RY8LY904FJRY","","-6.99",""
"10/01/2019","03:46:20","PDT","","Bank Deposit to PP Account ","Pending","USD","6.99","0.00","6.99","","simon@joyful.com","0UT1454T080467333","","","06P57143A2806728E","","0.00",""
"10/01/2019","08:57:01","PDT","Patreon","PreApproved Payment Bill User Payment","Completed","USD","-7.00","0.00","-7.00","simon@joyful.com","support@patreon.com","2723294R5F587612G","Patreon* Membership","","B-0PG3907E47M86318M","","-7.00",""
"10/01/2019","08:57:01","PDT","","Bank Deposit to PP Account ","Pending","USD","7.00","0.00","7.00","","simon@joyful.com","78154807RG994149F","Patreon* Membership","","2723294R5F587612G","","0.00",""
"10/19/2019","03:02:12","PDT","Wikimedia Foundation, Inc.","Subscription Payment","Completed","USD","-2.00","0.00","-2.00","simon@joyful.com","tle@wikimedia.org","KU943404RY432005M","Monthly donation to the Wikimedia Foundation","","I-R53CYUS3258L","","-2.00",""
"10/19/2019","03:02:12","PDT","","Bank Deposit to PP Account ","Pending","USD","2.00","0.00","2.00","","simon@joyful.com","3XJ170193A851016F","","","KU943404RY432005M","","0.00",""
"10/22/2019","05:07:06","PDT","Noble Benefactor","Subscription Payment","Completed","USD","10.00","-0.59","9.41","noble@bene.fac.tor","simon@joyful.com","68LL1662YP3134303","Joyful Systems","","I-KCV9BG2YGDWB","","9.41",""
